RoomId,RoomType,PriceGroup,AmenitiesType,RoomNum,RoomFloor,AdaAccessible,StandardOccupancy,MaxOccupancy
1,2,4,3,201,2,0,2,4
2,2,3,1,202,2,1,2,4
3,2,4,3,203,2,0,2,4
4,2,3,1,204,2,1,2,4
5,1,2,4,205,2,0,2,2
6,1,1,2,206,2,1,2,2
7,1,2,4,207,2,0,2,2
8,1,1,2,208,2,1,2,2
9,2,4,3,301,3,0,2,4
10,2,3,1,302,3,1,2,4
11,2,4,3,303,3,0,2,4
12,2,3,1,304,3,1,2,4
13,1,2,4,305,3,0,2,2
14,1,1,2,306,3,1,2,2
15,1,2,4,307,3,0,2,2
16,1,1,2,308,3,1,2,2
17,3,5,5,401,4,1,3,8
18,3,5,5,402,4,1,3,8
